id	type
Microsoft	A
Amazon	A
HTC	A
Samsung	A
Apple	A
Motorola	A
Nokia	A
Kodak	A
Barnes & Noble	B
Foxconn	B
Oracle	B
Google	B
Inventec	B
LG	B
RIM	B
Sony	C
Qualcomm	C
Huawei	C
ZTE	C
Ericsson	C